.##.#####.
####..##.#
..#.##...#
.#...##..#
##.###....
##..##..##
.#.##...##
####....##
....###..#
##.#.#.#..
