.#..##..#...#..###.##....#....###.#..##..#...#..#.
.#..##..##....#...##.##....#.#.##....##....#...#..
###...##.##...####....#.##.#.###..#.......####.###
....#..##.#..#..##.#..##..##.....#.##....#.##.###.
#####.#####...#.#.....##.#..##..##.##..#####.#.#.#
####......#....#.....####.#...#..##..######.#.#.#.
...#####..##.#.##..#.####.##.#.....###.###.#.###..
..###.#...#..##.#.##..###..#......##...#####.####.
.#.##..#..###.#.#..##.###..#.#.##.##.###..#.##.##.
.#.##.###.##.#.#..#.#.##..##.#.#..###.....###...#.
#...###..##.##..##.####.#......#####..#.#..#.##..#
##.#.###..#.#..#...#..#.#.###.#.#.#..###..####....
#######..#.##....######.#.###..##...###.#...####.#
.#####.##..###.#..#..#.##..##.#...##.....#.#.###.#
#....##..#.#.......#.####...#.#..#.#..#...##..#..#
#..#####.#.#...#...#...#.###...#.#.##....####.....
##.#...#..##..#..#.#..###########.#..##..#####....
.#.##..#.#.##.##.#...###.##..##.......#...###.####
####.###.#.####.#....###......#...####....#..#####
#.....#..#.##..#.###.##.....#..##......#...#..#..#
...###..#.#####.##..##..#.##..#.###.###.##.#####.#
#.####.#....##...##..##.#####...#.######..###..#.#
...#.#...#########.##.###..##.#.#..##..#....#..#..
..##.#..#.###.###..##..#....##.##...#.######.##.#.
#..#########..##.#######.#.#...#.###...#.#...#.##.
#.####..#.#.#.....##.##.###......##..###.###...###
.##.#....###.#.######...##.#.....#.##...##.#.##.##
###.##..##..#...##..#.###.##...#...###....###.###.
.#####.#.#.####.#.#..###.#...#####.##..##.#..####.
#..#..#.#.#.#....#.#.##..#...##..###...#....###..#
#.##..#.#.....#......#...######..#.####..#.#.....#
#.###....####.#..####..##.###.#.....#.##..##.#####
.#.###...#..#.####.##...###.#.#.##.#....#..#.###.#
..#......#..#.#...#####..##.####.###.....##.####.#
.#.....##......#.#..#.##..##.#.#########.##.#..###
##...##.#.##.###..####..#..#..##.####.#.#....#####
#.###.#.##.#..##.##...#....##..#.##.#....###.###.#
.#.##.#.########.#...#.#.#.#....##........#..###.#
....#.#..###...#.#....#####..#.##.##.#####...##...
.##..#.###.#.##.#..#.#.#.#####..###.##.#.#.##..#..
.#.##..###...##.###...#...##...###...#.##.##.#..##
.#..#.#..##..#...###.#.###.#..#......#.###.####.#.
#.#.#.######.##.#.#..#..#.#.######.###...#####.##.
.#.#.....#.##.##..######.###.####..#.#.....##..#.#
.#...#..###.#..#.######.#..##.##.###.#..###.##...#
....#.##########.#..#.....#.#..#.###..#....#.#..##
....##.#####.######..##.#.#.......####.#.####..###
..####.#.#..#.####.#..###..##..######....##.......
.#.#####.#.##.#......#..#.#...###.#.#.#.###..#..##
..#.#.##..###...#.......####.#.#.####....####.###.
