.#..###...
....#...#.
##########
...#..##.#
#..#...#..
##..###..#
##...#####
.##......#
##..#..#.#
####...#..
